11111111111111111111
11110000000000000001
11110000000000000001
11110006666666666331
11110002222222211331
11110002222222211331
11110002222222211331
15550002200000000331
10000005500000000331
10000001104000000331
10000001122222222331
10001111166666666111
10001111111111111111
10001111111111111111
10001111111111111111
11111111111111111111