7777777777777777777
7111122222222222227
7111100000000000007
7111100000000000007
7111100040000000007
7220000111110000007
7220000111111100007
7220000111111100007
7220000111111100007
7220000888888800007
7116666666666611117
7777777777777777777