1111111111111111111
1000000330000000001
1000000330000000001
1000000330000000001
1000000330000004001
1000000112211111111
1000000330000000001
1000000330000000001
1000000330000000001
1000000330000000001
1222222111111300001
1110000111111300001
1110000111111100001
1110000000000000001
1110000000000000311
1110000000000000311
1110000000000000111
1110000000550000111
1111111111111111111