7777777777777777777
7008800011100000007
7008800011100000007
7008800011100000007
7001100088800000007
7001100088800000007
7001100088800000007
7001166666666000007
7331111111111222227
7331111111111112227
7888888888888888887
7888888884888888887
7777777777777777777