777777777777777777777777777777777
700000000000000088122222222222227
700000000000000088188800000000007
700000000000000088188800000000007
700000000000000088188800004000007
700000000000000088188800666660007
700000000000000088188800111110007
700000300000003388188800111110007
700000300000003388188800888880007
700000300000003388888866666661117
700000300000668888888811111111117
700000300000112222222211111111117
700000322222116666611111111111117
777777777777777777777777777777777