1111111111111111111111111111
1111111111111111110000000001
1111111111111111110000000001
1111111111111111110000000001
1111111111111111110001110001
1111111111111111110001110001
1111111111111111110001110001
1111111111111111110001110001
1000000000000000000001110001
1000000000000000000001110001
1000000000000000000000000401
1111100000000011111111111111
1111122222222211111111111111
1111111111111111111111111111