1111111111111111111
1000000011100000001
1000000011100000001
1000000011100000001
1001100000000000001
1001100000000000001
1001100000000000001
1001166666666000001
1331111111111222221
1331111111111112221
1000000000000000001
1000000004000000001
1111111111111111111