1111111111111111111
1111122222222222221
1111100000000000001
1111100000000000001
1111100040000000001
1220000111110000001
1220000111111100001
1220000111111100001
1220000111111100001
1220000000000000001
1116666666666611111