77777777777777777777777
71111111100000000880007
71111111100000000880007
71111111100000000880007
71111111100000000110007
71111111100000000110007
71111111100000000110007
75555551100000000110007
70000001100000000110007
70000005500000000550007
70000008800000000880407
71110008800011111111117
71112222222211111111117
77777777777777777777777