11111111111111111111111
11111111100000000000001
11111111100000000000001
11111111100000000000001
11111111100000000110001
11111111100000000110001
11111111100000000110001
15555551100000000110001
10000001100000000110001
10000005500000000550001
10000000000000000000401
11110000000011111111111
11112222222211111111111
11111111111111111111111