11111111111111111111111111111
11111111111111100033300000001
11111555555551100033300000001
10000000000000000011100000001
10000000000000000011100000001
10000000000000000011100000001
10000000000000000011100000001
10000000000000000022200000001
10000000000000000022200000001
10000000000000000022200040001
11111000000001111111111111111
11111555555551111111111111111
11111111111111111111111111111