7777777777777777777
7000000338888800007
7000000338888800007
7000000338888800007
7000000338888800407
7000000112211111117
7000000338888800007
7000000338888800007
7000000338888800007
7000000338888800007
7222222111111300007
7110000111111300007
7110000111111100007
7110000888888800007
7110000888888800317
7110000888888800317
7110000888888800117
7110000888558800117
7777777777777777777