777777777777777777777777777777
788880000000000000000000000227
788880000000000000000000000227
788880000000000000000000000227
788880000000000000000000000227
788880000000000000000000000227
788880000000000000000300000227
788880000000000000000300000227
788880000000000000400500000227
788880000000000011111100000117
788880000000000011111100000887
788880000000000011111100000887
788880000000022211111111111887
788880000000028888888888888887
711110000000026666666666666117
711110000000021111111111111117
711110000000021111111111111117
711110000000021111111111111117
711111116666661111111111111117
777777777777777777777777777777