77777777777777777777
71110000000000000007
71110000000000000007
71110006666666666337
71110002222222211337
71110002222222211337
71110002222222211337
75550002288888888337
70000005588888888337
70000001184888888337
70000001122222222337
70001111166666666117
70001111111111111117
70001111111111111117
70001111111111111117
77777777777777777777