77777777777777777777
78888800000003333337
78888800000003333337
78888800000003334337
78888800000001111117
78888800000001111117
78888800000001111117
78888800555551111117
78888800000001111117
71111100000001111117
71111100000001111117
71111100000001111117
71111100000001111117
77777777777777777777