77777777777777777777777777777
71111111111111100088800000007
71111111111111100088800000007
71111222222221100011100000007
70000888888880000011100000007
70000888888880000011100000007
70000888888880000011100000007
70000888888880000022200000007
70000888888880000022200000007
70000888888880000022200040007
71111888888881111111111111117
71111555555551111111111111117
77777777777777777777777777777